................................................................................................................................................................................................
................................................................................................................................................................................................
................................................................................................................................................................................................
................................................................................................................................................................................................
................................................................................................................................................................................................
................................................................................................................................................................................................
................................................................................................................................................................................................
................................................................................................................................................................................................
................................................................................................................................................................................................
................................................................................................................................................................................................
................................................................................................................................................................................................
................................................................................................................................................................................................
................................................................................................................................................................................................
................................................................................................................................................................................................
................................................................................................................................................................................................
................................................................................................................................................................................................
................................................................................................................................................................................................
........■■■■■■..........■■...■■..■■■.■..■■.■■.■..............................................................■■..............................................................■■.■■■.■■■.........
.■■■■....■....■...........■...■......■..■...■.■.........................................................■■■■■■............................................................■■..■.■.■.■.■.........
..■..■..■.....■.■..■■.......■■...■...■..■...■.■.■■■■■...■■■■....■■...■....■..■...........■■■......■■.........■..........................................................■..■..■.■■■■■■■.........
.■...■..■■■...■..■..■......■.....■...■..■...■.■...■..■......■....■...■.......■.......■...■........■..........■..........................................................■..■..■...■.■...........
.■■■.■........■...■■.......■.....■..■...■...■.■...■..■.......■...■.■■■......■■...■■■■■.....■■■...■■■■■.......■..........................................................■..■..■.■■■■■■■.........
.....■........■.....■......■.....■.■....■...■.■...■..■.......■...■.■.........■...■.........■.....■.......■■■■■............................................................■■..■.■.■.■.■.........
.■■■■■........■.■■■■■......■.....■......■■■■■■■.■■■..■.......■...■■■.........■...................■...........■...............................................................■■.■■■.■■■.........
................................................................................................................................................................................................
.........■■■■■..................■■■..■■.■■■■.■■.■■■■■....■■■■...■■■■■■■.........................................................■■■■■...■..........................■■......■■...■■■■■■..■■...■■.
..■■■......■............■■■.■■■...■...■....■.■.......■.......■.......■..........................■■■■■■..■■...■■...■■.................■..■■■■■...■■.■■■..■■■■■........■......■.....■...■..■....■.
...■....■■■■■■■.........■.■.■.■.■.■........■.■.......■.......■.......■....................■■■....■....■..■..■.■....■..................■.....■....■■...■..■...■.......■......■....■....■...■..■..
.■■■■■.....■............■■■.■■■..........■.■.■.......■.......■.......■...■■■■.....■■.......■....■.....■..■....■....■.....■■■..........■.....■....■....■.■....■.......■......■....■....■...■..■..
.■...■..■■■■■■■.................■■■.■■■..■.■.........■..■■■■■■.......■......■......■.......■....■.....■..■....■.............■.........■....■.....■....■.■....■.......■......■....■....■...■..■..
.■...■..■.■.■.■...................■...■..■.■.........■..■....■.......■...■..■......■.......■....■.....■..■....■.............■.........■...■......■....■.■....■.......■......■....■....■...■..■..
.■■■■■..■■■.■■■.................■.■...■.■■.■■■■.■■■■■■■.■....■■......■...■..■......■.......■....■.....■...■■■■...........■■■■.........■..■.......■.■■■■.■■■■■■....■■■■......■.....■■■■..■■■■■...
........................................................■.■.■.■.■.■.■.■...■■.■..................................................................................................................
..■■■...........■■■.■■■.........■■■■■■■...■■■....■■■■■■.■.■.■.■.■■■.■■■.................■■■.■■■..■■.■■..■■■.■■■.■■■.■■■...■■■...■■■......■..........■■■.■■■■■...■...■...■■■■■■..................
..■.■.............■.■...■.....■.■.■.■.■...■......■....■...■.■.....■.■...■.■.■■.■........■.....■.■.....■.■.....■.■.....■...........■.....■■■...........■.■...■...■■■■■...■....■....■■■...■■.■■■■.
.■■.■■..■■■.■■■.■■■.■■■.■.....■.■.....■.■.■.■.■..■■■....■.....■.■...■■■...■....■..■■■...■.■■■.■.■.■■■.■.■■■.■■■.■■.■.■■.■.■■■.■...■......■....■.■■■■■.■.■...■...■...■...■■■..■.....■.....■.■..■.
..■.■.....■.■...■.■.■.■.■.....■.■.■.■.■.■.■.■.■..■......■.....■.■■■...■.■....■.....■....■..■..■.■..■..■............■....■.■.■.■...■..■...■■■■■■.■...■...■■■■■...■■■■■.....■..■...■■■■■...■■■..■.
..■.■...■.■.■.■.■.■.■.■.■■■.■■■.■.■.■.■.■.■.■.■.■■■■■■■...■.■.....■.■...■.■■.■.■...■.......■............■.■.■.■.■■.■.■■.■.■■■.■...■..■...■....■.■...■.....■.......■.....■■■..■...■...■...■.■..■.
........■.■.■.■.■.■.■.■...■.■.....■.■.......■...■.....■.■.■.■.■.■■■.■■■..........■.■.■...■.■.■..■..■..■.■.■.■.■.■.....■..........■■■■■■.......■.■...■....■■■.....■■■....■....■...■...■..■■.■■■■.
........■.■.■.■.■.■■■.■.■■■■■■■.■■■.■■■...■■■...■.....■.■.■.■.■.■.■.■.■...■.■■..■■.■.■■.■■.■.■■.■■.■.■■.■■■.■■■.■■■.■■■...■■■........■.......■■.■■■■■.....■.......■.....■■■■■■..■■■■■■■.........
................................................................................................................................................................................................
.■...■.....■............................................■.■■■.■............................................................■.......■....■■.■.■■.■■■■■■■.■■■■■■■.■■■■■■■...■.......■.■.....■.■...
.■■■■■.....■.....■■.■■....■.■.....■.......■■■...■.■■■.■.■.....■............................................................■.......■....■..■..■.■.■...■.■.■...■.■.■...■.■■■.■...■■■.■■■..■■.■■..
.■...■.....■.....■...■...■...■.......■..■.....■.■.■.■.■.■.....■............................................................■.....■.■.■..■■.■.■■.■■■■■■■.■■■■■■■.■■■■■■■.....■.......■.....■.■...
...........■.......■.......■.......■....■.....■.■.■.■.■.■..■..■....■■■....■■■■....■■■■....■■■.....■.■....■.■■■...■■.■■.....■.....■.■.■..................■.■.....■.■...■.■■■.■...■■■.■.....■.■...
..■.■...■■■■■■■..■...■...■...■...■......■.....■.■.....■.■..■..■............■......■..■....■.■.....■.■....■.■.■...■...■..■■.■.■■.■■.■.■■.................■.■.....■.■.■■■.....■.......■...■■■.■■■.
..■.■............■■.■■....■.■.......■...■.....■.■.....■....■.........■.....■......■..■....■■■.....■■■■...■■■■■...■.■.■.....■.....■.■.■..................■.■.....■.■.■...■■■.■...■■■.■■■...■.■...
..■■■...■■■■■■■.........................■■■■■■■.■■■■■■■....■.......■■■.....■■.....■■■■....■.......■........■.....■■■■■.....■.......■....................■■■.....■■■■■.....■.......■.■...■■■.■■■.
................................................................................................................................................................................................
■■■■■■■.■■■■■■..........■.....■...............................................................................■..■■......■■■■■...■■■....■■■■■■■.■■■■■■■.■■■■■■■..........■■■■■....■.■.....■■■...
■.....■.■....■..........■.....■.........................................................................■■■■■■■...■......■..■......■.............■....■.■.....■..........■...■....■.■.......■...
■.■.■.■.■.■■.■..■■■■■.■.■■■■■■■...■...............................................■.■......................■......■.■....■■■■......■.............■....■.■.........■.■.............■■■...■■....■.
■.....■.■....■..■.....■...........■.........■.....■.......■■■■■.■■■■■■...■.■.■....■.■......■......■...............■.■....■..■......■■■..■■■......■....■.■...............................■.....■.
■.■■■.■.■....■..■.■■■■■.■■■■■■■...■■■.....■■■.....■■■.....■.■.....■.■....■.■.■....■.■......■......■■■......■......■.■....■..■........■...........■....■.■.........................■■■...■....■■.
■.....■.■■■■■■..........■.....■...........■.■.......■.....■.■.....■.■....■.■.■....■■■......■......■.■...■..■......■.■....■..■........■...........■....■.■........■...■....■.■.....■.■.....■.....
■■■■■■■.■....■..........■.....■...■■■.....■■■■...■■■■.....■■■.....■.■......■.......■.......■........■...■■■■■■..■■■.■■■..■..■■...■■■■■..■■■■■■■..■....■.■........■■■■■....■■■.....■.■.....■■■...
................................................................................................................................................................................................
.................................................................................................................................................■■■■■...■■■■■..........■■■■■■■.................
.................................................................................................................................................■...........■..........■.....■..........■■■■■..
.■.......■.......■■■■■...■■■■■...■■■■■...■■■■■...■■■■■...■■■■■...■■■■■...■■■■■...■...■...■...■...■...■...■■■■■....■.■....■■■■■...■...■...■■■■■...................■■■.■..■.■.■.■...■.■...........
.■.......■.......■.■.■...■...■...■...■.......■...■...■...■.......■.........■.....■...■...■...■...■.■.■.....■......■.■.....■.■....■...■......■...■■■.........■■■..■.■.■..■.■.■.■...■.■.....■.■...
.■■■■■...■.......■.■.■...■...■...■...■...■■■■■...■...■...■.......■■■■■.....■.....■...■...■.■■■...■.■.■...........■■■■■...■■■■■...■■■■■....■.■....................■.■■■..■.....■.................
.■.......■.......■.■.■...■...■...■...■...■.......■.■.■...■...........■.....■.....■...■...■.■.....■.■.■.....■......■.■.....■.■......■......■......■...........■..........■.■.■.■...■.■.....■■■...
.■.......■■■■■...■.■.■...■...■...■■■■■...■.......■■■■■...■.......■■■■■.....■.....■■■■■...■.■.....■■■■■...■■■■■....■.■....■■■■■.....■.....■■■■■...■■■■■...■■■■■..........■.■■■.■...■■■.....■.■...
................................................................................................................................................................................................
.■■■■■...■...■...........■...■...■■■■■...■...■...■■■■■..■■■■■■..■■■■.....■■■■■■....■....................■■......................................................................................
...■.....■...■...■...■...■...■.....■.....■...■......■...■..........■..........■..■.■.■..........................................................................................................
...■.....■...■...■...■...■...■...........■...■......■...■.....................■..■...■...........................■■■■■...■.......■■■■■.......■...■■■■■...■■■■■...■■■■■...■...■...■■■■■.......■..
...■.....■...■...■...■...■.■.■...........■■■■■....■.■...■.....................■......................................■...■.......■...........■...........................■...■.....■.........■..
...■.....■...■...■.■■■...■.■.■.............■......■.....■.....................■............■.....................■■■■■...■■■■■...■.......■■■■■...■■■■■...■■■■■.....■■■...■■■■■.....■.........■..
...■.....■...■...■.■.....■.■.■.....■.......■......■.....■..........■..........■..........■.■.■...................■...■.......■...■...............■.......■...........■...■...■.....■.........■..
...■.....■■■■■...■.■.....■■■■■...■■■■■.....■.....■■■■■..■■■■■■.....■■■■..■■■■■■..........■...■..■■■■■■...........■...■...■■■■■...■■■■■...■■■■■...■■■■■...■.......■■■■■...■...■...■■■■■...■■■■■..
................................................................................................................................................................................................
...■■■...........■■■....■■■■■■■.■■■■■■■..■■■■■...■■■.....■■■■■...■■■■■...■■■■■...■■■■■...■■■■■...■...■...■■■■■.......■...■.......■.......■■■■■...■■■■■...■■■■■...■■■■■...■■■■■...■■■■■...■■■■■..
..............................■.■.....■..■...■.....■.....■.......■...............................■...■.....■.........■...■.......■.......■.■.■...■...■...■...■.......■...■...■...■.......■......
........■■■■■■■...............■.■.■■■.■..■...■.....■.....■.......■..■............................■...■.....■.........■...■.......■.......■.■.■...■...■...■...■.......■...■...■...■.......■......
■■■.................■■■.■■■■■■■.■.■.■.■..■■■■■...■■■■■...■.......■..■....■■■■■...■■■■■.....■■■...■■■■■.....■.........■...■■■■■...■.......■.■.■...■...■...■...■...■■■■■...■.■■■...■...■...■■■■■..
........■■■■■■■............■....■.■■■■■..■...■.......■...■.......■..■....■.......■...........■...■...■.....■.........■...■.......■.......■.■.■...■...■...■...■...■.......■...■...■...■.......■..
...........................■....■........■...■.......■...■.......■.......■.......■...........■...■...■.....■.........■...■.......■.......■.■.■...■...■...■...■...■.......■...■...■...■.......■..
...■■■...........■■■.......■....■■■■■■■..■...■...■■■■■...■■■■■...■■■■■...■■■■■...■.......■■■■■...■...■...■■■■■...■■■■■...■.......■■■■■...■.■.■...■...■...■■■■■...■.......■■■■■...■...■...■■■■■..
................................................................................................................................................................................................
.■■.■■....■■■.....■■■....■.■.■.....■....■..■..■.■..■■■■....................■■■■...■■■.............■■■......■......■■■.....■■■.....■.■.....■■■.....■■■.....■■■.....■■■.....■■■...................
..■.■.....■.■............■.■.■...■■■■■..■..■..■.■..■..■....................■.......■.....■■■■■....■.■......■........■.......■.....■.■.....■.......■.........■.....■.■.....■.■.....■■■.....■■■...
..■.■..............■.......■.....■...■..■..■..■.■■■■..■.........................■.....■..■...■....■.■......■........■.......■.....■.■.....■.......■.........■.....■.■.....■.■...................
■■■■■■■.■■■.■■■....■.......■....■■...■■.........................................■■...■■..■.■.■....■.■......■......■■■.....■■■.....■■■.....■■■.....■■■.......■.....■■■.....■■■...................
..■.■..............■.......■.....■...■..■.■.■.■.■.■■■.■.........................■.....■..■.■.■....■.■......■......■.........■.......■.......■.....■.■.......■.....■.■.......■...................
..■.■.....■.■............■.■.■...■■■■■..■.■.■.■.■.■.■.■....■.......■.......■.......■.....■...■....■.■......■......■.........■.......■.......■.....■.■.......■.....■.■.......■.....■■■.......■...
.■■.■■....■■■.....■■■....■.■.■.....■....■.■.■.■.■■■.■■■...■■.......■....■■■■......■■■....■■■■■....■■■......■......■■■.....■■■.......■.....■■■.....■■■.......■.....■■■.......■.............■■■...
................................................................................................................................................................................................
■.■■■.■.........■■...■■.■■■.■■■...■.■.....■.■...■.■.■.■..■.■.■....■■■...■■■■■■■...■.■..............■.....■■■.■■.■■■■..■....■....■■■■■■...■■■■■■....■.......■.....■■.■■....................■.■...
...■....■■..■■..■■...■■.■.■.■.■...■.■.....■.■...........■■■■■■■...■.■...■..■..■...■.■.....■.■...■■■■■■■.........■..■..■....■....■.............■....■.......■......■.■.....................■.■...
■.■.■.■.■■..■■....■■■...■■■.■■■.■■■.■■■.■■■.■■■.■.■.■.■..■.■.■....■.■...■..■..■..........■■■■■..■..■.....■■■....■..■..■.........■.............■....■.......■....■■■.■■■.........................
■■...■■...■■......■■■...................................■■■■■■■...■.■...■..■..■...........■.■...■■■■■■■.........■■■■■■■.........................■■■■■■■.■■■■■■■.........■■■■■■■.■■■■■■■.■■■■■■■.
■.■.■.■...■■......■■■...■■■.■■■.■■■.■■■.■■■.■■■.■.■.■.■..■.■.■....■■■...■■■■■■■..........■■■■■.....■..■....■■■..■...............■.............■....■.......■....■■■.■■■.........................
...■....■■..■■..■■...■■.■.■.■.■...■.■.....■.■...........■■■■■■■...........................■.■...■■■■■■■.........■...............■.............■....■.......■......■.■.....................■.■...
■.■■■.■.■■..■■..■■...■■.■■■.■■■...■.■.....■.■...■.■.■.■..■.■.■....■■■...■■■■■■■....................■....■■.■■■..■■■■■■■.........■■■■■■...■■■■■■....■.......■.....■■.■■....................■.■...
................■■■■■■■■........■■■■■■■■................................................■■....■■..■..■...........................................................................■.■.■.■........
................■■■■■■■■■■■■■■■.■......■■■■■■■■.■■■■■■■.■■■■■■■.■■■■■.....■■■......■....■......■...........■.......■.............■...■...■■■■■..........................■■......■.■.■.■..■...■..
................■■■■■■■■■■■■■■■.■......■■.....■.■.....■.■.....■.■...■..............■............■.■..■.■...■.......■....■.....■..■...■...■...■...........................■.......■.■.■.■■■■.■■■.
................■■■■■■■■■■■■■■■.■......■■.....■.■.■■■.■.■.■■■.■.■.■■■■■.■.....■............................■.......■....■.....■..■...■...■...■..................■■......■■......■.■.■.■..■.■.■..
................■■■■■■■■■■■■■■■.■......■■.....■.■.■■■.■.■.■.■.■.■.■.■.■.■.....■.■■...■■.................................■..■..■..■...■...■...■...................■.......■.......■.■.■.■..■■■...
................■■■■■■■■■■■■■■■.■......■■.....■.■.■■■.■.■.■■■.■.■■■■■.■.■.....■.................■.■..■.■...■.......■....■..■..■....■....................■■......■■......■■......■.■.■.■..■.■.■..
................■■■■■■■■■■■■■■■.■......■■.....■.■.....■.■.....■...■...■............■....■......■...........■.......■.......■.....■.■.■...■...■...........■.......■.......■.......■.■.■.■■■■.■■■.
................■■■■■■■■■■■■■■■.■■■■■■■■■■■■■■■.■■■■■■■.■■■■■■■...■■■■■...■■■......■....■■....■■..■..■.....■.......■.......■....■■.■.■■.■■...■■.■■......■■......■■......■■......■.■.■.■..■...■..
